1111111111111111111111111111111111
10000000000000000C000000E000000001
1010010100100000101001001000010101
101111001010101000100101C100010101
11P0000000000000000000000000000001
1111111111111111111111111111111111