1111111111111111111111111111111111
10000000000000000C00000000E0000001
1010010100100000101001001100010101
101111001010101000100101CC10000101
11P0000000000000000000000100000001
1111111111111111111111111111111111